Gene_Combo	Seq
lpg0404a_Spacer+repeat	GCAAGTTACGGATACTGTCTACAGGTTTTAGAGCTATGCTGTTTTGAATGGTCCCAAAAC
lpg0404a_repeat+spacer	GTTTTAGAGCTATGCTGTTTTGAATGGTCCCAAAACGCAAGTTACGGATACTGTCTACAG
lpg0404a_SpacerRC+repeat	CTGTAGACAGTATCCGTAACTTGCGTTTTAGAGCTATGCTGTTTTGAATGGTCCCAAAAC
lpg0404a_repeat+SpacerRC	GTTTTAGAGCTATGCTGTTTTGAATGGTCCCAAAACCTGTAGACAGTATCCGTAACTTGC
lpg0404a_Spacer+repeatRC	GCAAGTTACGGATACTGTCTACAGGTTTTGGGACCATTCAAAACAGCATAGCTCTAAAAC
lpg0404a_repeatRC+spacer	GTTTTGGGACCATTCAAAACAGCATAGCTCTAAAACGCAAGTTACGGATACTGTCTACAG
lpg0404a_SpacerRC+repeatRC	CTGTAGACAGTATCCGTAACTTGCGTTTTGGGACCATTCAAAACAGCATAGCTCTAAAAC
lpg0404a_repeatRC+SpacerRC	GTTTTGGGACCATTCAAAACAGCATAGCTCTAAAACCTGTAGACAGTATCCGTAACTTGC
lpg0404b_Spacer+repeat	GGGTGCCTTGTTCTTCCTTATCCCGTTTTAGAGCTATGCTGTTTTGAATGGTCCCAAAAC
lpg0404b_repeat+spacer	GTTTTAGAGCTATGCTGTTTTGAATGGTCCCAAAACGGGTGCCTTGTTCTTCCTTATCCC
lpg0404b_SpacerRC+repeat	GGGATAAGGAAGAACAAGGCACCCGTTTTAGAGCTATGCTGTTTTGAATGGTCCCAAAAC
lpg0404b_repeat+SpacerRC	GTTTTAGAGCTATGCTGTTTTGAATGGTCCCAAAACGGGATAAGGAAGAACAAGGCACCC
lpg0404b_Spacer+repeatRC	GGGTGCCTTGTTCTTCCTTATCCCGTTTTGGGACCATTCAAAACAGCATAGCTCTAAAAC
lpg0404b_repeatRC+spacer	GTTTTGGGACCATTCAAAACAGCATAGCTCTAAAACGGGTGCCTTGTTCTTCCTTATCCC
lpg0404b_SpacerRC+repeatRC	GGGATAAGGAAGAACAAGGCACCCGTTTTGGGACCATTCAAAACAGCATAGCTCTAAAAC
lpg0404b_repeatRC+SpacerRC	GTTTTGGGACCATTCAAAACAGCATAGCTCTAAAACGGGATAAGGAAGAACAAGGCACCC
lpg1658a_Spacer+repeat	CTTATCTGTTTTAAGTCTTGCCTTGTTTTAGAGCTATGCTGTTTTGAATGGTCCCAAAAC
lpg1658a_repeat+spacer	GTTTTAGAGCTATGCTGTTTTGAATGGTCCCAAAACCTTATCTGTTTTAAGTCTTGCCTT
lpg1658a_SpacerRC+repeat	AAGGCAAGACTTAAAACAGATAAGGTTTTAGAGCTATGCTGTTTTGAATGGTCCCAAAAC
lpg1658a_repeat+SpacerRC	GTTTTAGAGCTATGCTGTTTTGAATGGTCCCAAAACAAGGCAAGACTTAAAACAGATAAG
lpg1658a_Spacer+repeatRC	CTTATCTGTTTTAAGTCTTGCCTTGTTTTGGGACCATTCAAAACAGCATAGCTCTAAAAC
lpg1658a_repeatRC+spacer	GTTTTGGGACCATTCAAAACAGCATAGCTCTAAAACCTTATCTGTTTTAAGTCTTGCCTT
lpg1658a_SpacerRC+repeatRC	AAGGCAAGACTTAAAACAGATAAGGTTTTGGGACCATTCAAAACAGCATAGCTCTAAAAC
lpg1658a_repeatRC+SpacerRC	GTTTTGGGACCATTCAAAACAGCATAGCTCTAAAACAAGGCAAGACTTAAAACAGATAAG
lpg1658b_Spacer+repeat	GCAGCCGCTTTAGCGGGGAACCAGGTTTTAGAGCTATGCTGTTTTGAATGGTCCCAAAAC
lpg1658b_repeat+spacer	GTTTTAGAGCTATGCTGTTTTGAATGGTCCCAAAACGCAGCCGCTTTAGCGGGGAACCAG
lpg1658b_SpacerRC+repeat	CTGGTTCCCCGCTAAAGCGGCTGCGTTTTAGAGCTATGCTGTTTTGAATGGTCCCAAAAC
lpg1658b_repeat+SpacerRC	GTTTTAGAGCTATGCTGTTTTGAATGGTCCCAAAACCTGGTTCCCCGCTAAAGCGGCTGC
lpg1658b_Spacer+repeatRC	GCAGCCGCTTTAGCGGGGAACCAGGTTTTGGGACCATTCAAAACAGCATAGCTCTAAAAC
lpg1658b_repeatRC+spacer	GTTTTGGGACCATTCAAAACAGCATAGCTCTAAAACGCAGCCGCTTTAGCGGGGAACCAG
lpg1658b_SpacerRC+repeatRC	CTGGTTCCCCGCTAAAGCGGCTGCGTTTTGGGACCATTCAAAACAGCATAGCTCTAAAAC
lpg1658b_repeatRC+SpacerRC	GTTTTGGGACCATTCAAAACAGCATAGCTCTAAAACCTGGTTCCCCGCTAAAGCGGCTGC
lpg1691a_Spacer+repeat	TGCCTATCAGCGCAAAACTTGGATGTTTTAGAGCTATGCTGTTTTGAATGGTCCCAAAAC
lpg1691a_repeat+spacer	GTTTTAGAGCTATGCTGTTTTGAATGGTCCCAAAACTGCCTATCAGCGCAAAACTTGGAT
lpg1691a_SpacerRC+repeat	ATCCAAGTTTTGCGCTGATAGGCAGTTTTAGAGCTATGCTGTTTTGAATGGTCCCAAAAC
lpg1691a_repeat+SpacerRC	GTTTTAGAGCTATGCTGTTTTGAATGGTCCCAAAACATCCAAGTTTTGCGCTGATAGGCA
lpg1691a_Spacer+repeatRC	TGCCTATCAGCGCAAAACTTGGATGTTTTGGGACCATTCAAAACAGCATAGCTCTAAAAC
lpg1691a_repeatRC+spacer	GTTTTGGGACCATTCAAAACAGCATAGCTCTAAAACTGCCTATCAGCGCAAAACTTGGAT
lpg1691a_SpacerRC+repeatRC	ATCCAAGTTTTGCGCTGATAGGCAGTTTTGGGACCATTCAAAACAGCATAGCTCTAAAAC
lpg1691a_repeatRC+SpacerRC	GTTTTGGGACCATTCAAAACAGCATAGCTCTAAAACATCCAAGTTTTGCGCTGATAGGCA
lpg1691b_Spacer+repeat	TTACCTTTTTTATTCCAGTAGCATGTTTTAGAGCTATGCTGTTTTGAATGGTCCCAAAAC
lpg1691b_repeat+spacer	GTTTTAGAGCTATGCTGTTTTGAATGGTCCCAAAACTTACCTTTTTTATTCCAGTAGCAT
lpg1691b_SpacerRC+repeat	ATGCTACTGGAATAAAAAAGGTAAGTTTTAGAGCTATGCTGTTTTGAATGGTCCCAAAAC
lpg1691b_repeat+SpacerRC	GTTTTAGAGCTATGCTGTTTTGAATGGTCCCAAAACATGCTACTGGAATAAAAAAGGTAA
lpg1691b_Spacer+repeatRC	TTACCTTTTTTATTCCAGTAGCATGTTTTGGGACCATTCAAAACAGCATAGCTCTAAAAC
lpg1691b_repeatRC+spacer	GTTTTGGGACCATTCAAAACAGCATAGCTCTAAAACTTACCTTTTTTATTCCAGTAGCAT
lpg1691b_SpacerRC+repeatRC	ATGCTACTGGAATAAAAAAGGTAAGTTTTGGGACCATTCAAAACAGCATAGCTCTAAAAC
lpg1691b_repeatRC+SpacerRC	GTTTTGGGACCATTCAAAACAGCATAGCTCTAAAACATGCTACTGGAATAAAAAAGGTAA
lpg1917a_Spacer+repeat	CTGAAAAAATATCCGTTCTTGCTTGTTTTAGAGCTATGCTGTTTTGAATGGTCCCAAAAC
lpg1917a_repeat+spacer	GTTTTAGAGCTATGCTGTTTTGAATGGTCCCAAAACCTGAAAAAATATCCGTTCTTGCTT
lpg1917a_SpacerRC+repeat	AAGCAAGAACGGATATTTTTTCAGGTTTTAGAGCTATGCTGTTTTGAATGGTCCCAAAAC
lpg1917a_repeat+SpacerRC	GTTTTAGAGCTATGCTGTTTTGAATGGTCCCAAAACAAGCAAGAACGGATATTTTTTCAG
lpg1917a_Spacer+repeatRC	CTGAAAAAATATCCGTTCTTGCTTGTTTTGGGACCATTCAAAACAGCATAGCTCTAAAAC
lpg1917a_repeatRC+spacer	GTTTTGGGACCATTCAAAACAGCATAGCTCTAAAACCTGAAAAAATATCCGTTCTTGCTT
lpg1917a_SpacerRC+repeatRC	AAGCAAGAACGGATATTTTTTCAGGTTTTGGGACCATTCAAAACAGCATAGCTCTAAAAC
lpg1917a_repeatRC+SpacerRC	GTTTTGGGACCATTCAAAACAGCATAGCTCTAAAACAAGCAAGAACGGATATTTTTTCAG
lpg1917b_Spacer+repeat	GAGCAATTGACAGCATTAGAAATTGTTTTAGAGCTATGCTGTTTTGAATGGTCCCAAAAC
lpg1917b_repeat+spacer	GTTTTAGAGCTATGCTGTTTTGAATGGTCCCAAAACGAGCAATTGACAGCATTAGAAATT
lpg1917b_SpacerRC+repeat	AATTTCTAATGCTGTCAATTGCTCGTTTTAGAGCTATGCTGTTTTGAATGGTCCCAAAAC
lpg1917b_repeat+SpacerRC	GTTTTAGAGCTATGCTGTTTTGAATGGTCCCAAAACAATTTCTAATGCTGTCAATTGCTC
lpg1917b_Spacer+repeatRC	GAGCAATTGACAGCATTAGAAATTGTTTTGGGACCATTCAAAACAGCATAGCTCTAAAAC
lpg1917b_repeatRC+spacer	GTTTTGGGACCATTCAAAACAGCATAGCTCTAAAACGAGCAATTGACAGCATTAGAAATT
lpg1917b_SpacerRC+repeatRC	AATTTCTAATGCTGTCAATTGCTCGTTTTGGGACCATTCAAAACAGCATAGCTCTAAAAC
lpg1917b_repeatRC+SpacerRC	GTTTTGGGACCATTCAAAACAGCATAGCTCTAAAACAATTTCTAATGCTGTCAATTGCTC
lpg0281a_Spacer+repeat	TTTATGGGCTTGGAACTATATTGGGTTTTAGAGCTATGCTGTTTTGAATGGTCCCAAAAC
lpg0281a_repeat+spacer	GTTTTAGAGCTATGCTGTTTTGAATGGTCCCAAAACTTTATGGGCTTGGAACTATATTGG
lpg0281a_SpacerRC+repeat	CCAATATAGTTCCAAGCCCATAAAGTTTTAGAGCTATGCTGTTTTGAATGGTCCCAAAAC
lpg0281a_repeat+SpacerRC	GTTTTAGAGCTATGCTGTTTTGAATGGTCCCAAAACCCAATATAGTTCCAAGCCCATAAA
lpg0281a_Spacer+repeatRC	TTTATGGGCTTGGAACTATATTGGGTTTTGGGACCATTCAAAACAGCATAGCTCTAAAAC
lpg0281a_repeatRC+spacer	GTTTTGGGACCATTCAAAACAGCATAGCTCTAAAACTTTATGGGCTTGGAACTATATTGG
lpg0281a_SpacerRC+repeatRC	CCAATATAGTTCCAAGCCCATAAAGTTTTGGGACCATTCAAAACAGCATAGCTCTAAAAC
lpg0281a_repeatRC+SpacerRC	GTTTTGGGACCATTCAAAACAGCATAGCTCTAAAACCCAATATAGTTCCAAGCCCATAAA
lpg0281b_Spacer+repeat	TATCCCATGGTTTTGTCAAATATTGTTTTAGAGCTATGCTGTTTTGAATGGTCCCAAAAC
lpg0281b_repeat+spacer	GTTTTAGAGCTATGCTGTTTTGAATGGTCCCAAAACTATCCCATGGTTTTGTCAAATATT
lpg0281b_SpacerRC+repeat	AATATTTGACAAAACCATGGGATAGTTTTAGAGCTATGCTGTTTTGAATGGTCCCAAAAC
lpg0281b_repeat+SpacerRC	GTTTTAGAGCTATGCTGTTTTGAATGGTCCCAAAACAATATTTGACAAAACCATGGGATA
lpg0281b_Spacer+repeatRC	TATCCCATGGTTTTGTCAAATATTGTTTTGGGACCATTCAAAACAGCATAGCTCTAAAAC
lpg0281b_repeatRC+spacer	GTTTTGGGACCATTCAAAACAGCATAGCTCTAAAACTATCCCATGGTTTTGTCAAATATT
lpg0281b_SpacerRC+repeatRC	AATATTTGACAAAACCATGGGATAGTTTTGGGACCATTCAAAACAGCATAGCTCTAAAAC
lpg0281b_repeatRC+SpacerRC	GTTTTGGGACCATTCAAAACAGCATAGCTCTAAAACAATATTTGACAAAACCATGGGATA
lpg0970a_Spacer+repeat	GCTCTTTTGTTACTTACACTTCTGGTTTTAGAGCTATGCTGTTTTGAATGGTCCCAAAAC
lpg0970a_repeat+spacer	GTTTTAGAGCTATGCTGTTTTGAATGGTCCCAAAACGCTCTTTTGTTACTTACACTTCTG
lpg0970a_SpacerRC+repeat	CAGAAGTGTAAGTAACAAAAGAGCGTTTTAGAGCTATGCTGTTTTGAATGGTCCCAAAAC
lpg0970a_repeat+SpacerRC	GTTTTAGAGCTATGCTGTTTTGAATGGTCCCAAAACCAGAAGTGTAAGTAACAAAAGAGC
lpg0970a_Spacer+repeatRC	GCTCTTTTGTTACTTACACTTCTGGTTTTGGGACCATTCAAAACAGCATAGCTCTAAAAC
lpg0970a_repeatRC+spacer	GTTTTGGGACCATTCAAAACAGCATAGCTCTAAAACGCTCTTTTGTTACTTACACTTCTG
lpg0970a_SpacerRC+repeatRC	CAGAAGTGTAAGTAACAAAAGAGCGTTTTGGGACCATTCAAAACAGCATAGCTCTAAAAC
lpg0970a_repeatRC+SpacerRC	GTTTTGGGACCATTCAAAACAGCATAGCTCTAAAACCAGAAGTGTAAGTAACAAAAGAGC
lpg0970b_Spacer+repeat	GTGAAGTAATTAATCTTGTTGGCCGTTTTAGAGCTATGCTGTTTTGAATGGTCCCAAAAC
lpg0970b_repeat+spacer	GTTTTAGAGCTATGCTGTTTTGAATGGTCCCAAAACGTGAAGTAATTAATCTTGTTGGCC
lpg0970b_SpacerRC+repeat	GGCCAACAAGATTAATTACTTCACGTTTTAGAGCTATGCTGTTTTGAATGGTCCCAAAAC
lpg0970b_repeat+SpacerRC	GTTTTAGAGCTATGCTGTTTTGAATGGTCCCAAAACGGCCAACAAGATTAATTACTTCAC
lpg0970b_Spacer+repeatRC	GTGAAGTAATTAATCTTGTTGGCCGTTTTGGGACCATTCAAAACAGCATAGCTCTAAAAC
lpg0970b_repeatRC+spacer	GTTTTGGGACCATTCAAAACAGCATAGCTCTAAAACGTGAAGTAATTAATCTTGTTGGCC
lpg0970b_SpacerRC+repeatRC	GGCCAACAAGATTAATTACTTCACGTTTTGGGACCATTCAAAACAGCATAGCTCTAAAAC
lpg0970b_repeatRC+SpacerRC	GTTTTGGGACCATTCAAAACAGCATAGCTCTAAAACGGCCAACAAGATTAATTACTTCAC
lpg0026a_Spacer+repeat	TGATATTCTCCTATGTTGTTGCCGGTTTTAGAGCTATGCTGTTTTGAATGGTCCCAAAAC
lpg0026a_repeat+spacer	GTTTTAGAGCTATGCTGTTTTGAATGGTCCCAAAACTGATATTCTCCTATGTTGTTGCCG
lpg0026a_SpacerRC+repeat	CGGCAACAACATAGGAGAATATCAGTTTTAGAGCTATGCTGTTTTGAATGGTCCCAAAAC
lpg0026a_repeat+SpacerRC	GTTTTAGAGCTATGCTGTTTTGAATGGTCCCAAAACCGGCAACAACATAGGAGAATATCA
lpg0026a_Spacer+repeatRC	TGATATTCTCCTATGTTGTTGCCGGTTTTGGGACCATTCAAAACAGCATAGCTCTAAAAC
lpg0026a_repeatRC+spacer	GTTTTGGGACCATTCAAAACAGCATAGCTCTAAAACTGATATTCTCCTATGTTGTTGCCG
lpg0026a_SpacerRC+repeatRC	CGGCAACAACATAGGAGAATATCAGTTTTGGGACCATTCAAAACAGCATAGCTCTAAAAC
lpg0026a_repeatRC+SpacerRC	GTTTTGGGACCATTCAAAACAGCATAGCTCTAAAACCGGCAACAACATAGGAGAATATCA
lpg0026b_Spacer+repeat	TTAGTGTTTTTGACCTTACCTTTTGTTTTAGAGCTATGCTGTTTTGAATGGTCCCAAAAC
lpg0026b_repeat+spacer	GTTTTAGAGCTATGCTGTTTTGAATGGTCCCAAAACTTAGTGTTTTTGACCTTACCTTTT
lpg0026b_SpacerRC+repeat	AAAAGGTAAGGTCAAAAACACTAAGTTTTAGAGCTATGCTGTTTTGAATGGTCCCAAAAC
lpg0026b_repeat+SpacerRC	GTTTTAGAGCTATGCTGTTTTGAATGGTCCCAAAACAAAAGGTAAGGTCAAAAACACTAA
lpg0026b_Spacer+repeatRC	TTAGTGTTTTTGACCTTACCTTTTGTTTTGGGACCATTCAAAACAGCATAGCTCTAAAAC
lpg0026b_repeatRC+spacer	GTTTTGGGACCATTCAAAACAGCATAGCTCTAAAACTTAGTGTTTTTGACCTTACCTTTT
lpg0026b_SpacerRC+repeatRC	AAAAGGTAAGGTCAAAAACACTAAGTTTTGGGACCATTCAAAACAGCATAGCTCTAAAAC
lpg0026b_repeatRC+SpacerRC	GTTTTGGGACCATTCAAAACAGCATAGCTCTAAAACAAAAGGTAAGGTCAAAAACACTAA
lpg0049a_Spacer+repeat	TCATTCTTGCTATTGCTTTGGCAGGTTTTAGAGCTATGCTGTTTTGAATGGTCCCAAAAC
lpg0049a_repeat+spacer	GTTTTAGAGCTATGCTGTTTTGAATGGTCCCAAAACTCATTCTTGCTATTGCTTTGGCAG
lpg0049a_SpacerRC+repeat	CTGCCAAAGCAATAGCAAGAATGAGTTTTAGAGCTATGCTGTTTTGAATGGTCCCAAAAC
lpg0049a_repeat+SpacerRC	GTTTTAGAGCTATGCTGTTTTGAATGGTCCCAAAACCTGCCAAAGCAATAGCAAGAATGA
lpg0049a_Spacer+repeatRC	TCATTCTTGCTATTGCTTTGGCAGGTTTTGGGACCATTCAAAACAGCATAGCTCTAAAAC
lpg0049a_repeatRC+spacer	GTTTTGGGACCATTCAAAACAGCATAGCTCTAAAACTCATTCTTGCTATTGCTTTGGCAG
lpg0049a_SpacerRC+repeatRC	CTGCCAAAGCAATAGCAAGAATGAGTTTTGGGACCATTCAAAACAGCATAGCTCTAAAAC
lpg0049a_repeatRC+SpacerRC	GTTTTGGGACCATTCAAAACAGCATAGCTCTAAAACCTGCCAAAGCAATAGCAAGAATGA
lpg0049b_Spacer+repeat	TTGAAGCGTGAACTCAGTCTATTTGTTTTAGAGCTATGCTGTTTTGAATGGTCCCAAAAC
lpg0049b_repeat+spacer	GTTTTAGAGCTATGCTGTTTTGAATGGTCCCAAAACTTGAAGCGTGAACTCAGTCTATTT
lpg0049b_SpacerRC+repeat	AAATAGACTGAGTTCACGCTTCAAGTTTTAGAGCTATGCTGTTTTGAATGGTCCCAAAAC
lpg0049b_repeat+SpacerRC	GTTTTAGAGCTATGCTGTTTTGAATGGTCCCAAAACAAATAGACTGAGTTCACGCTTCAA
lpg0049b_Spacer+repeatRC	TTGAAGCGTGAACTCAGTCTATTTGTTTTGGGACCATTCAAAACAGCATAGCTCTAAAAC
lpg0049b_repeatRC+spacer	GTTTTGGGACCATTCAAAACAGCATAGCTCTAAAACTTGAAGCGTGAACTCAGTCTATTT
lpg0049b_SpacerRC+repeatRC	AAATAGACTGAGTTCACGCTTCAAGTTTTGGGACCATTCAAAACAGCATAGCTCTAAAAC
lpg0049b_repeatRC+SpacerRC	GTTTTGGGACCATTCAAAACAGCATAGCTCTAAAACAAATAGACTGAGTTCACGCTTCAA
lpg0228a_Spacer+repeat	CTTTGTGAACTGGGAACGATGTTTGTTTTAGAGCTATGCTGTTTTGAATGGTCCCAAAAC
lpg0228a_repeat+spacer	GTTTTAGAGCTATGCTGTTTTGAATGGTCCCAAAACCTTTGTGAACTGGGAACGATGTTT
lpg0228a_SpacerRC+repeat	AAACATCGTTCCCAGTTCACAAAGGTTTTAGAGCTATGCTGTTTTGAATGGTCCCAAAAC
lpg0228a_repeat+SpacerRC	GTTTTAGAGCTATGCTGTTTTGAATGGTCCCAAAACAAACATCGTTCCCAGTTCACAAAG
lpg0228a_Spacer+repeatRC	CTTTGTGAACTGGGAACGATGTTTGTTTTGGGACCATTCAAAACAGCATAGCTCTAAAAC
lpg0228a_repeatRC+spacer	GTTTTGGGACCATTCAAAACAGCATAGCTCTAAAACCTTTGTGAACTGGGAACGATGTTT
lpg0228a_SpacerRC+repeatRC	AAACATCGTTCCCAGTTCACAAAGGTTTTGGGACCATTCAAAACAGCATAGCTCTAAAAC
lpg0228a_repeatRC+SpacerRC	GTTTTGGGACCATTCAAAACAGCATAGCTCTAAAACAAACATCGTTCCCAGTTCACAAAG
lpg0228b_Spacer+repeat	TGAATATATTAGTTGCATCAGCTGGTTTTAGAGCTATGCTGTTTTGAATGGTCCCAAAAC
lpg0228b_repeat+spacer	GTTTTAGAGCTATGCTGTTTTGAATGGTCCCAAAACTGAATATATTAGTTGCATCAGCTG
lpg0228b_SpacerRC+repeat	CAGCTGATGCAACTAATATATTCAGTTTTAGAGCTATGCTGTTTTGAATGGTCCCAAAAC
lpg0228b_repeat+SpacerRC	GTTTTAGAGCTATGCTGTTTTGAATGGTCCCAAAACCAGCTGATGCAACTAATATATTCA
lpg0228b_Spacer+repeatRC	TGAATATATTAGTTGCATCAGCTGGTTTTGGGACCATTCAAAACAGCATAGCTCTAAAAC
lpg0228b_repeatRC+spacer	GTTTTGGGACCATTCAAAACAGCATAGCTCTAAAACTGAATATATTAGTTGCATCAGCTG
lpg0228b_SpacerRC+repeatRC	CAGCTGATGCAACTAATATATTCAGTTTTGGGACCATTCAAAACAGCATAGCTCTAAAAC
lpg0228b_repeatRC+SpacerRC	GTTTTGGGACCATTCAAAACAGCATAGCTCTAAAACCAGCTGATGCAACTAATATATTCA
lpg2388a_Spacer+repeat	ACAGCCTGGCTTGCTTGCCTTTATGTTTTAGAGCTATGCTGTTTTGAATGGTCCCAAAAC
lpg2388a_repeat+spacer	GTTTTAGAGCTATGCTGTTTTGAATGGTCCCAAAACACAGCCTGGCTTGCTTGCCTTTAT
lpg2388a_SpacerRC+repeat	ATAAAGGCAAGCAAGCCAGGCTGTGTTTTAGAGCTATGCTGTTTTGAATGGTCCCAAAAC
lpg2388a_repeat+SpacerRC	GTTTTAGAGCTATGCTGTTTTGAATGGTCCCAAAACATAAAGGCAAGCAAGCCAGGCTGT
lpg2388a_Spacer+repeatRC	ACAGCCTGGCTTGCTTGCCTTTATGTTTTGGGACCATTCAAAACAGCATAGCTCTAAAAC
lpg2388a_repeatRC+spacer	GTTTTGGGACCATTCAAAACAGCATAGCTCTAAAACACAGCCTGGCTTGCTTGCCTTTAT
lpg2388a_SpacerRC+repeatRC	ATAAAGGCAAGCAAGCCAGGCTGTGTTTTGGGACCATTCAAAACAGCATAGCTCTAAAAC
lpg2388a_repeatRC+SpacerRC	GTTTTGGGACCATTCAAAACAGCATAGCTCTAAAACATAAAGGCAAGCAAGCCAGGCTGT
lpg2388b_Spacer+repeat	GCATCAAAATCATAAGGACATGTGGTTTTAGAGCTATGCTGTTTTGAATGGTCCCAAAAC
lpg2388b_repeat+spacer	GTTTTAGAGCTATGCTGTTTTGAATGGTCCCAAAACGCATCAAAATCATAAGGACATGTG
lpg2388b_SpacerRC+repeat	CACATGTCCTTATGATTTTGATGCGTTTTAGAGCTATGCTGTTTTGAATGGTCCCAAAAC
lpg2388b_repeat+SpacerRC	GTTTTAGAGCTATGCTGTTTTGAATGGTCCCAAAACCACATGTCCTTATGATTTTGATGC
lpg2388b_Spacer+repeatRC	GCATCAAAATCATAAGGACATGTGGTTTTGGGACCATTCAAAACAGCATAGCTCTAAAAC
lpg2388b_repeatRC+spacer	GTTTTGGGACCATTCAAAACAGCATAGCTCTAAAACGCATCAAAATCATAAGGACATGTG
lpg2388b_SpacerRC+repeatRC	CACATGTCCTTATGATTTTGATGCGTTTTGGGACCATTCAAAACAGCATAGCTCTAAAAC
lpg2388b_repeatRC+SpacerRC	GTTTTGGGACCATTCAAAACAGCATAGCTCTAAAACCACATGTCCTTATGATTTTGATGC