Gene_Combination	Seq
lpg2815_Spacer+repeat	ATTAAGCCCCAAAAAATCCCTTATGTTTTAGAGCTATGCTGTTTTGAATGGTCCCAAAAC
lpg2815_repeat+spacer	GTTTTAGAGCTATGCTGTTTTGAATGGTCCCAAAACATTAAGCCCCAAAAAATCCCTTAT
lpg2815_SpacerRC+repeat	ATAAGGGATTTTTTGGGGCTTAATGTTTTAGAGCTATGCTGTTTTGAATGGTCCCAAAAC
lpg2815_repeat+SpacerRC	GTTTTAGAGCTATGCTGTTTTGAATGGTCCCAAAACATAAGGGATTTTTTGGGGCTTAAT
lpg2815_Spacer+repeatRC	ATTAAGCCCCAAAAAATCCCTTATGTTTTGGGACCATTCAAAACAGCATAGCTCTAAAAC
lpg2815_repeatRC+spacer	GTTTTGGGACCATTCAAAACAGCATAGCTCTAAAACATTAAGCCCCAAAAAATCCCTTAT
lpg2815_SpacerRC+repeatRC	ATAAGGGATTTTTTGGGGCTTAATGTTTTGGGACCATTCAAAACAGCATAGCTCTAAAAC
lpg2815_repeatRC+SpacerRC	GTTTTGGGACCATTCAAAACAGCATAGCTCTAAAACATAAGGGATTTTTTGGGGCTTAAT
lpg0016_Spacer+repeat	ACGATAGGTATAAAGAACATCGTGTTTTAGAGCTATGCTGTTTTGAATGGTCCCAAAAC
lpg0016_repeat+spacer	GTTTTAGAGCTATGCTGTTTTGAATGGTCCCAAAACACGATAGGTATAAAGAACATCGT
lpg0016_SpacerRC+repeat	ACGATGTTCTTTATACCTATCGTGTTTTAGAGCTATGCTGTTTTGAATGGTCCCAAAAC
lpg0016_repeat+SpacerRC	GTTTTAGAGCTATGCTGTTTTGAATGGTCCCAAAACACGATGTTCTTTATACCTATCGT
lpg0016_Spacer+repeatRC	ACGATAGGTATAAAGAACATCGTGTTTTGGGACCATTCAAAACAGCATAGCTCTAAAAC
lpg0016_repeatRC+spacer	GTTTTGGGACCATTCAAAACAGCATAGCTCTAAAACACGATAGGTATAAAGAACATCGT
lpg0016_SpacerRC+repeatRC	ACGATGTTCTTTATACCTATCGTGTTTTGGGACCATTCAAAACAGCATAGCTCTAAAAC
lpg0016_repeatRC+SpacerRC	GTTTTGGGACCATTCAAAACAGCATAGCTCTAAAACACGATGTTCTTTATACCTATCGT
lpg0059_Spacer+repeat	ACAGAACAATAATTCAGCCTTTGTGTTTTAGAGCTATGCTGTTTTGAATGGTCCCAAAAC
lpg0059_repeat+spacer	GTTTTAGAGCTATGCTGTTTTGAATGGTCCCAAAACACAGAACAATAATTCAGCCTTTGT
lpg0059_SpacerRC+repeat	ACAAAGGCTGAATTATTGTTCTGTGTTTTAGAGCTATGCTGTTTTGAATGGTCCCAAAAC
lpg0059_repeat+SpacerRC	GTTTTAGAGCTATGCTGTTTTGAATGGTCCCAAAACACAAAGGCTGAATTATTGTTCTGT
lpg0059_Spacer+repeatRC	ACAGAACAATAATTCAGCCTTTGTGTTTTGGGACCATTCAAAACAGCATAGCTCTAAAAC
lpg0059_repeatRC+spacer	GTTTTGGGACCATTCAAAACAGCATAGCTCTAAAACACAGAACAATAATTCAGCCTTTGT
lpg0059_SpacerRC+repeatRC	ACAAAGGCTGAATTATTGTTCTGTGTTTTGGGACCATTCAAAACAGCATAGCTCTAAAAC
lpg0059_repeatRC+SpacerRC	GTTTTGGGACCATTCAAAACAGCATAGCTCTAAAACACAAAGGCTGAATTATTGTTCTGT
lpg0086_Spacer+repeat	CATGCGAGTGATGAAAATCAGGCTGTTTTAGAGCTATGCTGTTTTGAATGGTCCCAAAAC
lpg0086_repeat+spacer	GTTTTAGAGCTATGCTGTTTTGAATGGTCCCAAAACCATGCGAGTGATGAAAATCAGGCT
lpg0086_SpacerRC+repeat	AGCCTGATTTTCATCACTCGCATGGTTTTAGAGCTATGCTGTTTTGAATGGTCCCAAAAC
lpg0086_repeat+SpacerRC	GTTTTAGAGCTATGCTGTTTTGAATGGTCCCAAAACAGCCTGATTTTCATCACTCGCATG
lpg0086_Spacer+repeatRC	CATGCGAGTGATGAAAATCAGGCTGTTTTGGGACCATTCAAAACAGCATAGCTCTAAAAC
lpg0086_repeatRC+spacer	GTTTTGGGACCATTCAAAACAGCATAGCTCTAAAACCATGCGAGTGATGAAAATCAGGCT
lpg0086_SpacerRC+repeatRC	AGCCTGATTTTCATCACTCGCATGGTTTTGGGACCATTCAAAACAGCATAGCTCTAAAAC
lpg0086_repeatRC+SpacerRC	GTTTTGGGACCATTCAAAACAGCATAGCTCTAAAACAGCCTGATTTTCATCACTCGCATG
lpg0096_Spacer+repeat	AAAGTTATTATTTTTACCGATTTTGTTTTAGAGCTATGCTGTTTTGAATGGTCCCAAAAC
lpg0096_repeat+spacer	GTTTTAGAGCTATGCTGTTTTGAATGGTCCCAAAACAAAGTTATTATTTTTACCGATTTT
lpg0096_SpacerRC+repeat	AAAATCGGTAAAAATAATAACTTTGTTTTAGAGCTATGCTGTTTTGAATGGTCCCAAAAC
lpg0096_repeat+SpacerRC	GTTTTAGAGCTATGCTGTTTTGAATGGTCCCAAAACAAAATCGGTAAAAATAATAACTTT
lpg0096_Spacer+repeatRC	AAAGTTATTATTTTTACCGATTTTGTTTTGGGACCATTCAAAACAGCATAGCTCTAAAAC
lpg0096_repeatRC+spacer	GTTTTGGGACCATTCAAAACAGCATAGCTCTAAAACAAAGTTATTATTTTTACCGATTTT
lpg0096_SpacerRC+repeatRC	AAAATCGGTAAAAATAATAACTTTGTTTTGGGACCATTCAAAACAGCATAGCTCTAAAAC
lpg0096_repeatRC+SpacerRC	GTTTTGGGACCATTCAAAACAGCATAGCTCTAAAACAAAATCGGTAAAAATAATAACTTT
lpg0107_Spacer+repeat	AAACCATAGACTTGACTCGTCTTGGTTTTAGAGCTATGCTGTTTTGAATGGTCCCAAAAC
lpg0107_repeat+spacer	GTTTTAGAGCTATGCTGTTTTGAATGGTCCCAAAACAAACCATAGACTTGACTCGTCTTG
lpg0107_SpacerRC+repeat	CAAGACGAGTCAAGTCTATGGTTTGTTTTAGAGCTATGCTGTTTTGAATGGTCCCAAAAC
lpg0107_repeat+SpacerRC	GTTTTAGAGCTATGCTGTTTTGAATGGTCCCAAAACCAAGACGAGTCAAGTCTATGGTTT
lpg0107_Spacer+repeatRC	AAACCATAGACTTGACTCGTCTTGGTTTTGGGACCATTCAAAACAGCATAGCTCTAAAAC
lpg0107_repeatRC+spacer	GTTTTGGGACCATTCAAAACAGCATAGCTCTAAAACAAACCATAGACTTGACTCGTCTTG
lpg0107_SpacerRC+repeatRC	CAAGACGAGTCAAGTCTATGGTTTGTTTTGGGACCATTCAAAACAGCATAGCTCTAAAAC
lpg0107_repeatRC+SpacerRC	GTTTTGGGACCATTCAAAACAGCATAGCTCTAAAACCAAGACGAGTCAAGTCTATGGTTT
lpg0140_Spacer+repeat	ATTATTAGTCATTTATTAAAAATAGTTTTAGAGCTATGCTGTTTTGAATGGTCCCAAAAC
lpg0140_repeat+spacer	GTTTTAGAGCTATGCTGTTTTGAATGGTCCCAAAACATTATTAGTCATTTATTAAAAATA
lpg0140_SpacerRC+repeat	TATTTTTAATAAATGACTAATAATGTTTTAGAGCTATGCTGTTTTGAATGGTCCCAAAAC
lpg0140_repeat+SpacerRC	GTTTTAGAGCTATGCTGTTTTGAATGGTCCCAAAACTATTTTTAATAAATGACTAATAAT
lpg0140_Spacer+repeatRC	ATTATTAGTCATTTATTAAAAATAGTTTTGGGACCATTCAAAACAGCATAGCTCTAAAAC
lpg0140_repeatRC+spacer	GTTTTGGGACCATTCAAAACAGCATAGCTCTAAAACATTATTAGTCATTTATTAAAAATA
lpg0140_SpacerRC+repeatRC	TATTTTTAATAAATGACTAATAATGTTTTGGGACCATTCAAAACAGCATAGCTCTAAAAC
lpg0140_repeatRC+SpacerRC	GTTTTGGGACCATTCAAAACAGCATAGCTCTAAAACTATTTTTAATAAATGACTAATAAT
lpg0171_Spacer+repeat	CAAAGCCTGGACTCCAAAAGTTACGTTTTAGAGCTATGCTGTTTTGAATGGTCCCAAAAC
lpg0171_repeat+spacer	GTTTTAGAGCTATGCTGTTTTGAATGGTCCCAAAACCAAAGCCTGGACTCCAAAAGTTAC
lpg0171_SpacerRC+repeat	GTAACTTTTGGAGTCCAGGCTTTGGTTTTAGAGCTATGCTGTTTTGAATGGTCCCAAAAC
lpg0171_repeat+SpacerRC	GTTTTAGAGCTATGCTGTTTTGAATGGTCCCAAAACGTAACTTTTGGAGTCCAGGCTTTG
lpg0171_Spacer+repeatRC	CAAAGCCTGGACTCCAAAAGTTACGTTTTGGGACCATTCAAAACAGCATAGCTCTAAAAC
lpg0171_repeatRC+spacer	GTTTTGGGACCATTCAAAACAGCATAGCTCTAAAACCAAAGCCTGGACTCCAAAAGTTAC
lpg0171_SpacerRC+repeatRC	GTAACTTTTGGAGTCCAGGCTTTGGTTTTGGGACCATTCAAAACAGCATAGCTCTAAAAC
lpg0171_repeatRC+SpacerRC	GTTTTGGGACCATTCAAAACAGCATAGCTCTAAAACGTAACTTTTGGAGTCCAGGCTTTG
lpg0246_Spacer+repeat	TATGCGTTGGAACGAGTACGACGGGTTTTAGAGCTATGCTGTTTTGAATGGTCCCAAAAC
lpg0246_repeat+spacer	GTTTTAGAGCTATGCTGTTTTGAATGGTCCCAAAACTATGCGTTGGAACGAGTACGACGG
lpg0246_SpacerRC+repeat	CCGTCGTACTCGTTCCAACGCATAGTTTTAGAGCTATGCTGTTTTGAATGGTCCCAAAAC
lpg0246_repeat+SpacerRC	GTTTTAGAGCTATGCTGTTTTGAATGGTCCCAAAACCCGTCGTACTCGTTCCAACGCATA
lpg0246_Spacer+repeatRC	TATGCGTTGGAACGAGTACGACGGGTTTTGGGACCATTCAAAACAGCATAGCTCTAAAAC
lpg0246_repeatRC+spacer	GTTTTGGGACCATTCAAAACAGCATAGCTCTAAAACTATGCGTTGGAACGAGTACGACGG
lpg0246_SpacerRC+repeatRC	CCGTCGTACTCGTTCCAACGCATAGTTTTGGGACCATTCAAAACAGCATAGCTCTAAAAC
lpg0246_repeatRC+SpacerRC	GTTTTGGGACCATTCAAAACAGCATAGCTCTAAAACCCGTCGTACTCGTTCCAACGCATA
lpg0404_Spacer+repeat	TTGGCTCTGTAGACAGTATCCGTAGTTTTAGAGCTATGCTGTTTTGAATGGTCCCAAAAC
lpg0404_repeat+spacer	GTTTTAGAGCTATGCTGTTTTGAATGGTCCCAAAACTTGGCTCTGTAGACAGTATCCGTA
lpg0404_SpacerRC+repeat	TACGGATACTGTCTACAGAGCCAAGTTTTAGAGCTATGCTGTTTTGAATGGTCCCAAAAC
lpg0404_repeat+SpacerRC	GTTTTAGAGCTATGCTGTTTTGAATGGTCCCAAAACTACGGATACTGTCTACAGAGCCAA
lpg0404_Spacer+repeatRC	TTGGCTCTGTAGACAGTATCCGTAGTTTTGGGACCATTCAAAACAGCATAGCTCTAAAAC
lpg0404_repeatRC+spacer	GTTTTGGGACCATTCAAAACAGCATAGCTCTAAAACTTGGCTCTGTAGACAGTATCCGTA
lpg0404_SpacerRC+repeatRC	TACGGATACTGTCTACAGAGCCAAGTTTTGGGACCATTCAAAACAGCATAGCTCTAAAAC
lpg0404_repeatRC+SpacerRC	GTTTTGGGACCATTCAAAACAGCATAGCTCTAAAACTACGGATACTGTCTACAGAGCCAA
lpg0439_Spacer+repeat	TATTAATGACAAACTGTAAAACCAGTTTTAGAGCTATGCTGTTTTGAATGGTCCCAAAAC
lpg0439_repeat+spacer	GTTTTAGAGCTATGCTGTTTTGAATGGTCCCAAAACTATTAATGACAAACTGTAAAACCA
lpg0439_SpacerRC+repeat	TGGTTTTACAGTTTGTCATTAATAGTTTTAGAGCTATGCTGTTTTGAATGGTCCCAAAAC
lpg0439_repeat+SpacerRC	GTTTTAGAGCTATGCTGTTTTGAATGGTCCCAAAACTGGTTTTACAGTTTGTCATTAATA
lpg0439_Spacer+repeatRC	TATTAATGACAAACTGTAAAACCAGTTTTGGGACCATTCAAAACAGCATAGCTCTAAAAC
lpg0439_repeatRC+spacer	GTTTTGGGACCATTCAAAACAGCATAGCTCTAAAACTATTAATGACAAACTGTAAAACCA
lpg0439_SpacerRC+repeatRC	TGGTTTTACAGTTTGTCATTAATAGTTTTGGGACCATTCAAAACAGCATAGCTCTAAAAC
lpg0439_repeatRC+SpacerRC	GTTTTGGGACCATTCAAAACAGCATAGCTCTAAAACTGGTTTTACAGTTTGTCATTAATA
lpg0518_Spacer+repeat	TAGAACAGAAATTGAATCGCTCATGTTTTAGAGCTATGCTGTTTTGAATGGTCCCAAAAC
lpg0518_repeat+spacer	GTTTTAGAGCTATGCTGTTTTGAATGGTCCCAAAACTAGAACAGAAATTGAATCGCTCAT
lpg0518_SpacerRC+repeat	ATGAGCGATTCAATTTCTGTTCTAGTTTTAGAGCTATGCTGTTTTGAATGGTCCCAAAAC
lpg0518_repeat+SpacerRC	GTTTTAGAGCTATGCTGTTTTGAATGGTCCCAAAACATGAGCGATTCAATTTCTGTTCTA
lpg0518_Spacer+repeatRC	TAGAACAGAAATTGAATCGCTCATGTTTTGGGACCATTCAAAACAGCATAGCTCTAAAAC
lpg0518_repeatRC+spacer	GTTTTGGGACCATTCAAAACAGCATAGCTCTAAAACTAGAACAGAAATTGAATCGCTCAT
lpg0518_SpacerRC+repeatRC	ATGAGCGATTCAATTTCTGTTCTAGTTTTGGGACCATTCAAAACAGCATAGCTCTAAAAC
lpg0518_repeatRC+SpacerRC	GTTTTGGGACCATTCAAAACAGCATAGCTCTAAAACATGAGCGATTCAATTTCTGTTCTA
lpg0621_Spacer+repeat	AAAAATATCGAACTCCCATCCGATGTTTTAGAGCTATGCTGTTTTGAATGGTCCCAAAAC
lpg0621_repeat+spacer	GTTTTAGAGCTATGCTGTTTTGAATGGTCCCAAAACAAAAATATCGAACTCCCATCCGAT
lpg0621_SpacerRC+repeat	ATCGGATGGGAGTTCGATATTTTTGTTTTAGAGCTATGCTGTTTTGAATGGTCCCAAAAC
lpg0621_repeat+SpacerRC	GTTTTAGAGCTATGCTGTTTTGAATGGTCCCAAAACATCGGATGGGAGTTCGATATTTTT
lpg0621_Spacer+repeatRC	AAAAATATCGAACTCCCATCCGATGTTTTGGGACCATTCAAAACAGCATAGCTCTAAAAC
lpg0621_repeatRC+spacer	GTTTTGGGACCATTCAAAACAGCATAGCTCTAAAACAAAAATATCGAACTCCCATCCGAT
lpg0621_SpacerRC+repeatRC	ATCGGATGGGAGTTCGATATTTTTGTTTTGGGACCATTCAAAACAGCATAGCTCTAAAAC
lpg0621_repeatRC+SpacerRC	GTTTTGGGACCATTCAAAACAGCATAGCTCTAAAACATCGGATGGGAGTTCGATATTTTT
lpg0716_Spacer+repeat	GTTTGCTATTAAAAAACATTAATGGTTTTAGAGCTATGCTGTTTTGAATGGTCCCAAAAC
lpg0716_repeat+spacer	GTTTTAGAGCTATGCTGTTTTGAATGGTCCCAAAACGTTTGCTATTAAAAAACATTAATG
lpg0716_SpacerRC+repeat	CATTAATGTTTTTTAATAGCAAACGTTTTAGAGCTATGCTGTTTTGAATGGTCCCAAAAC
lpg0716_repeat+SpacerRC	GTTTTAGAGCTATGCTGTTTTGAATGGTCCCAAAACCATTAATGTTTTTTAATAGCAAAC
lpg0716_Spacer+repeatRC	GTTTGCTATTAAAAAACATTAATGGTTTTGGGACCATTCAAAACAGCATAGCTCTAAAAC
lpg0716_repeatRC+spacer	GTTTTGGGACCATTCAAAACAGCATAGCTCTAAAACGTTTGCTATTAAAAAACATTAATG
lpg0716_SpacerRC+repeatRC	CATTAATGTTTTTTAATAGCAAACGTTTTGGGACCATTCAAAACAGCATAGCTCTAAAAC
lpg0716_repeatRC+SpacerRC	GTTTTGGGACCATTCAAAACAGCATAGCTCTAAAACCATTAATGTTTTTTAATAGCAAAC
lpg0879_Spacer+repeat	CCAAGCATTACAAGGAAAGTATGAGTTTTAGAGCTATGCTGTTTTGAATGGTCCCAAAAC
lpg0879_repeat+spacer	GTTTTAGAGCTATGCTGTTTTGAATGGTCCCAAAACCCAAGCATTACAAGGAAAGTATGA
lpg0879_SpacerRC+repeat	TCATACTTTCCTTGTAATGCTTGGGTTTTAGAGCTATGCTGTTTTGAATGGTCCCAAAAC
lpg0879_repeat+SpacerRC	GTTTTAGAGCTATGCTGTTTTGAATGGTCCCAAAACTCATACTTTCCTTGTAATGCTTGG
lpg0879_Spacer+repeatRC	CCAAGCATTACAAGGAAAGTATGAGTTTTGGGACCATTCAAAACAGCATAGCTCTAAAAC
lpg0879_repeatRC+spacer	GTTTTGGGACCATTCAAAACAGCATAGCTCTAAAACCCAAGCATTACAAGGAAAGTATGA
lpg0879_SpacerRC+repeatRC	TCATACTTTCCTTGTAATGCTTGGGTTTTGGGACCATTCAAAACAGCATAGCTCTAAAAC
lpg0879_repeatRC+SpacerRC	GTTTTGGGACCATTCAAAACAGCATAGCTCTAAAACTCATACTTTCCTTGTAATGCTTGG
lpg0963_Spacer+repeat	GCCTTAACTTTTTACGCGATGACTGTTTTAGAGCTATGCTGTTTTGAATGGTCCCAAAAC
lpg0963_repeat+spacer	GTTTTAGAGCTATGCTGTTTTGAATGGTCCCAAAACGCCTTAACTTTTTACGCGATGACT
lpg0963_SpacerRC+repeat	AGTCATCGCGTAAAAAGTTAAGGCGTTTTAGAGCTATGCTGTTTTGAATGGTCCCAAAAC
lpg0963_repeat+SpacerRC	GTTTTAGAGCTATGCTGTTTTGAATGGTCCCAAAACAGTCATCGCGTAAAAAGTTAAGGC
lpg0963_Spacer+repeatRC	GCCTTAACTTTTTACGCGATGACTGTTTTGGGACCATTCAAAACAGCATAGCTCTAAAAC
lpg0963_repeatRC+spacer	GTTTTGGGACCATTCAAAACAGCATAGCTCTAAAACGCCTTAACTTTTTACGCGATGACT
lpg0963_SpacerRC+repeatRC	AGTCATCGCGTAAAAAGTTAAGGCGTTTTGGGACCATTCAAAACAGCATAGCTCTAAAAC
lpg0963_repeatRC+SpacerRC	GTTTTGGGACCATTCAAAACAGCATAGCTCTAAAACAGTCATCGCGTAAAAAGTTAAGGC
lpg1099_Spacer+repeat	ATAATGTAATTCCCAGATTAAAAAGTTTTAGAGCTATGCTGTTTTGAATGGTCCCAAAAC
lpg1099_repeat+spacer	GTTTTAGAGCTATGCTGTTTTGAATGGTCCCAAAACATAATGTAATTCCCAGATTAAAAA
lpg1099_SpacerRC+repeat	TTTTTAATCTGGGAATTACATTATGTTTTAGAGCTATGCTGTTTTGAATGGTCCCAAAAC
lpg1099_repeat+SpacerRC	GTTTTAGAGCTATGCTGTTTTGAATGGTCCCAAAACTTTTTAATCTGGGAATTACATTAT
lpg1099_Spacer+repeatRC	ATAATGTAATTCCCAGATTAAAAAGTTTTGGGACCATTCAAAACAGCATAGCTCTAAAAC
lpg1099_repeatRC+spacer	GTTTTGGGACCATTCAAAACAGCATAGCTCTAAAACATAATGTAATTCCCAGATTAAAAA
lpg1099_SpacerRC+repeatRC	TTTTTAATCTGGGAATTACATTATGTTTTGGGACCATTCAAAACAGCATAGCTCTAAAAC
lpg1099_repeatRC+SpacerRC	GTTTTGGGACCATTCAAAACAGCATAGCTCTAAAACTTTTTAATCTGGGAATTACATTAT
lpg1137_Spacer+repeat	CATTTCATAGGGCGTCAACAGATAGTTTTAGAGCTATGCTGTTTTGAATGGTCCCAAAAC
lpg1137_repeat+spacer	GTTTTAGAGCTATGCTGTTTTGAATGGTCCCAAAACCATTTCATAGGGCGTCAACAGATA
lpg1137_SpacerRC+repeat	TATCTGTTGACGCCCTATGAAATGGTTTTAGAGCTATGCTGTTTTGAATGGTCCCAAAAC
lpg1137_repeat+SpacerRC	GTTTTAGAGCTATGCTGTTTTGAATGGTCCCAAAACTATCTGTTGACGCCCTATGAAATG
lpg1137_Spacer+repeatRC	CATTTCATAGGGCGTCAACAGATAGTTTTGGGACCATTCAAAACAGCATAGCTCTAAAAC
lpg1137_repeatRC+spacer	GTTTTGGGACCATTCAAAACAGCATAGCTCTAAAACCATTTCATAGGGCGTCAACAGATA
lpg1137_SpacerRC+repeatRC	TATCTGTTGACGCCCTATGAAATGGTTTTGGGACCATTCAAAACAGCATAGCTCTAAAAC
lpg1137_repeatRC+SpacerRC	GTTTTGGGACCATTCAAAACAGCATAGCTCTAAAACTATCTGTTGACGCCCTATGAAATG
lpg1148_Spacer+repeat	TCATTAAGTTGTCTGGCGTATTTTGTTTTAGAGCTATGCTGTTTTGAATGGTCCCAAAAC
lpg1148_repeat+spacer	GTTTTAGAGCTATGCTGTTTTGAATGGTCCCAAAACTCATTAAGTTGTCTGGCGTATTTT
lpg1148_SpacerRC+repeat	AAAATACGCCAGACAACTTAATGAGTTTTAGAGCTATGCTGTTTTGAATGGTCCCAAAAC
lpg1148_repeat+SpacerRC	GTTTTAGAGCTATGCTGTTTTGAATGGTCCCAAAACAAAATACGCCAGACAACTTAATGA
lpg1148_Spacer+repeatRC	TCATTAAGTTGTCTGGCGTATTTTGTTTTGGGACCATTCAAAACAGCATAGCTCTAAAAC
lpg1148_repeatRC+spacer	GTTTTGGGACCATTCAAAACAGCATAGCTCTAAAACTCATTAAGTTGTCTGGCGTATTTT
lpg1148_SpacerRC+repeatRC	AAAATACGCCAGACAACTTAATGAGTTTTGGGACCATTCAAAACAGCATAGCTCTAAAAC
lpg1148_repeatRC+SpacerRC	GTTTTGGGACCATTCAAAACAGCATAGCTCTAAAACAAAATACGCCAGACAACTTAATGA
lpg1525_Spacer+repeat	TTATCTTTTTTAGAAGCATCATTTGTTTTAGAGCTATGCTGTTTTGAATGGTCCCAAAAC
lpg1525_repeat+spacer	GTTTTAGAGCTATGCTGTTTTGAATGGTCCCAAAACTTATCTTTTTTAGAAGCATCATTT
lpg1525_SpacerRC+repeat	AAATGATGCTTCTAAAAAAGATAAGTTTTAGAGCTATGCTGTTTTGAATGGTCCCAAAAC
lpg1525_repeat+SpacerRC	GTTTTAGAGCTATGCTGTTTTGAATGGTCCCAAAACAAATGATGCTTCTAAAAAAGATAA
lpg1525_Spacer+repeatRC	TTATCTTTTTTAGAAGCATCATTTGTTTTGGGACCATTCAAAACAGCATAGCTCTAAAAC
lpg1525_repeatRC+spacer	GTTTTGGGACCATTCAAAACAGCATAGCTCTAAAACTTATCTTTTTTAGAAGCATCATTT
lpg1525_SpacerRC+repeatRC	AAATGATGCTTCTAAAAAAGATAAGTTTTGGGACCATTCAAAACAGCATAGCTCTAAAAC
lpg1525_repeatRC+SpacerRC	GTTTTGGGACCATTCAAAACAGCATAGCTCTAAAACAAATGATGCTTCTAAAAAAGATAA
lpg1527_Spacer+repeat	AAAAATAGACCCAGGGAAGTTACAGTTTTAGAGCTATGCTGTTTTGAATGGTCCCAAAAC
lpg1527_repeat+spacer	GTTTTAGAGCTATGCTGTTTTGAATGGTCCCAAAACAAAAATAGACCCAGGGAAGTTACA
lpg1527_SpacerRC+repeat	TGTAACTTCCCTGGGTCTATTTTTGTTTTAGAGCTATGCTGTTTTGAATGGTCCCAAAAC
lpg1527_repeat+SpacerRC	GTTTTAGAGCTATGCTGTTTTGAATGGTCCCAAAACTGTAACTTCCCTGGGTCTATTTTT
lpg1527_Spacer+repeatRC	AAAAATAGACCCAGGGAAGTTACAGTTTTGGGACCATTCAAAACAGCATAGCTCTAAAAC
lpg1527_repeatRC+spacer	GTTTTGGGACCATTCAAAACAGCATAGCTCTAAAACAAAAATAGACCCAGGGAAGTTACA
lpg1527_SpacerRC+repeatRC	TGTAACTTCCCTGGGTCTATTTTTGTTTTGGGACCATTCAAAACAGCATAGCTCTAAAAC
lpg1527_repeatRC+SpacerRC	GTTTTGGGACCATTCAAAACAGCATAGCTCTAAAACTGTAACTTCCCTGGGTCTATTTTT
lpg1621_Spacer+repeat	GTTAACAGGTAAAGTGCGAAATTAGTTTTAGAGCTATGCTGTTTTGAATGGTCCCAAAAC
lpg1621_repeat+spacer	GTTTTAGAGCTATGCTGTTTTGAATGGTCCCAAAACGTTAACAGGTAAAGTGCGAAATTA
lpg1621_SpacerRC+repeat	TAATTTCGCACTTTACCTGTTAACGTTTTAGAGCTATGCTGTTTTGAATGGTCCCAAAAC
lpg1621_repeat+SpacerRC	GTTTTAGAGCTATGCTGTTTTGAATGGTCCCAAAACTAATTTCGCACTTTACCTGTTAAC
lpg1621_Spacer+repeatRC	GTTAACAGGTAAAGTGCGAAATTAGTTTTGGGACCATTCAAAACAGCATAGCTCTAAAAC
lpg1621_repeatRC+spacer	GTTTTGGGACCATTCAAAACAGCATAGCTCTAAAACGTTAACAGGTAAAGTGCGAAATTA
lpg1621_SpacerRC+repeatRC	TAATTTCGCACTTTACCTGTTAACGTTTTGGGACCATTCAAAACAGCATAGCTCTAAAAC
lpg1621_repeatRC+SpacerRC	GTTTTGGGACCATTCAAAACAGCATAGCTCTAAAACTAATTTCGCACTTTACCTGTTAAC
lpg1661_Spacer+repeat	GGATAAAAGGCGTTGGGGTTTTAAGTTTTAGAGCTATGCTGTTTTGAATGGTCCCAAAAC
lpg1661_repeat+spacer	GTTTTAGAGCTATGCTGTTTTGAATGGTCCCAAAACGGATAAAAGGCGTTGGGGTTTTAA
lpg1661_SpacerRC+repeat	TTAAAACCCCAACGCCTTTTATCCGTTTTAGAGCTATGCTGTTTTGAATGGTCCCAAAAC
lpg1661_repeat+SpacerRC	GTTTTAGAGCTATGCTGTTTTGAATGGTCCCAAAACTTAAAACCCCAACGCCTTTTATCC
lpg1661_Spacer+repeatRC	GGATAAAAGGCGTTGGGGTTTTAAGTTTTGGGACCATTCAAAACAGCATAGCTCTAAAAC
lpg1661_repeatRC+spacer	GTTTTGGGACCATTCAAAACAGCATAGCTCTAAAACGGATAAAAGGCGTTGGGGTTTTAA
lpg1661_SpacerRC+repeatRC	TTAAAACCCCAACGCCTTTTATCCGTTTTGGGACCATTCAAAACAGCATAGCTCTAAAAC
lpg1661_repeatRC+SpacerRC	GTTTTGGGACCATTCAAAACAGCATAGCTCTAAAACTTAAAACCCCAACGCCTTTTATCC
lpg1689_Spacer+repeat	CCATCTATAGATTCCTGAGATTTAGTTTTAGAGCTATGCTGTTTTGAATGGTCCCAAAAC
lpg1689_repeat+spacer	GTTTTAGAGCTATGCTGTTTTGAATGGTCCCAAAACCCATCTATAGATTCCTGAGATTTA
lpg1689_SpacerRC+repeat	TAAATCTCAGGAATCTATAGATGGGTTTTAGAGCTATGCTGTTTTGAATGGTCCCAAAAC
lpg1689_repeat+SpacerRC	GTTTTAGAGCTATGCTGTTTTGAATGGTCCCAAAACTAAATCTCAGGAATCTATAGATGG
lpg1689_Spacer+repeatRC	CCATCTATAGATTCCTGAGATTTAGTTTTGGGACCATTCAAAACAGCATAGCTCTAAAAC
lpg1689_repeatRC+spacer	GTTTTGGGACCATTCAAAACAGCATAGCTCTAAAACCCATCTATAGATTCCTGAGATTTA
lpg1689_SpacerRC+repeatRC	TAAATCTCAGGAATCTATAGATGGGTTTTGGGACCATTCAAAACAGCATAGCTCTAAAAC
lpg1689_repeatRC+SpacerRC	GTTTTGGGACCATTCAAAACAGCATAGCTCTAAAACTAAATCTCAGGAATCTATAGATGG
lpg1701_Spacer+repeat	TAACTAATTCCTCGATATTGCAGTGTTTTAGAGCTATGCTGTTTTGAATGGTCCCAAAAC
lpg1701_repeat+spacer	GTTTTAGAGCTATGCTGTTTTGAATGGTCCCAAAACTAACTAATTCCTCGATATTGCAGT
lpg1701_SpacerRC+repeat	ACTGCAATATCGAGGAATTAGTTAGTTTTAGAGCTATGCTGTTTTGAATGGTCCCAAAAC
lpg1701_repeat+SpacerRC	GTTTTAGAGCTATGCTGTTTTGAATGGTCCCAAAACACTGCAATATCGAGGAATTAGTTA
lpg1701_Spacer+repeatRC	TAACTAATTCCTCGATATTGCAGTGTTTTGGGACCATTCAAAACAGCATAGCTCTAAAAC
lpg1701_repeatRC+spacer	GTTTTGGGACCATTCAAAACAGCATAGCTCTAAAACTAACTAATTCCTCGATATTGCAGT
lpg1701_SpacerRC+repeatRC	ACTGCAATATCGAGGAATTAGTTAGTTTTGGGACCATTCAAAACAGCATAGCTCTAAAAC
lpg1701_repeatRC+SpacerRC	GTTTTGGGACCATTCAAAACAGCATAGCTCTAAAACACTGCAATATCGAGGAATTAGTTA
lpg1702_Spacer+repeat	GATGATCAATAGAGAAGAAATTCTGTTTTAGAGCTATGCTGTTTTGAATGGTCCCAAAAC
lpg1702_repeat+spacer	GTTTTAGAGCTATGCTGTTTTGAATGGTCCCAAAACGATGATCAATAGAGAAGAAATTCT
lpg1702_SpacerRC+repeat	AGAATTTCTTCTCTATTGATCATCGTTTTAGAGCTATGCTGTTTTGAATGGTCCCAAAAC
lpg1702_repeat+SpacerRC	GTTTTAGAGCTATGCTGTTTTGAATGGTCCCAAAACAGAATTTCTTCTCTATTGATCATC
lpg1702_Spacer+repeatRC	GATGATCAATAGAGAAGAAATTCTGTTTTGGGACCATTCAAAACAGCATAGCTCTAAAAC
lpg1702_repeatRC+spacer	GTTTTGGGACCATTCAAAACAGCATAGCTCTAAAACGATGATCAATAGAGAAGAAATTCT
lpg1702_SpacerRC+repeatRC	AGAATTTCTTCTCTATTGATCATCGTTTTGGGACCATTCAAAACAGCATAGCTCTAAAAC
lpg1702_repeatRC+SpacerRC	GTTTTGGGACCATTCAAAACAGCATAGCTCTAAAACAGAATTTCTTCTCTATTGATCATC
lpg1776_Spacer+repeat	TCGCAGTGGCTTTGATTACCACAGGTTTTAGAGCTATGCTGTTTTGAATGGTCCCAAAAC
lpg1776_repeat+spacer	GTTTTAGAGCTATGCTGTTTTGAATGGTCCCAAAACTCGCAGTGGCTTTGATTACCACAG
lpg1776_SpacerRC+repeat	CTGTGGTAATCAAAGCCACTGCGAGTTTTAGAGCTATGCTGTTTTGAATGGTCCCAAAAC
lpg1776_repeat+SpacerRC	GTTTTAGAGCTATGCTGTTTTGAATGGTCCCAAAACCTGTGGTAATCAAAGCCACTGCGA
lpg1776_Spacer+repeatRC	TCGCAGTGGCTTTGATTACCACAGGTTTTGGGACCATTCAAAACAGCATAGCTCTAAAAC
lpg1776_repeatRC+spacer	GTTTTGGGACCATTCAAAACAGCATAGCTCTAAAACTCGCAGTGGCTTTGATTACCACAG
lpg1776_SpacerRC+repeatRC	CTGTGGTAATCAAAGCCACTGCGAGTTTTGGGACCATTCAAAACAGCATAGCTCTAAAAC
lpg1776_repeatRC+SpacerRC	GTTTTGGGACCATTCAAAACAGCATAGCTCTAAAACCTGTGGTAATCAAAGCCACTGCGA
lpg1907_Spacer+repeat	AATAAGAACAGCCCTTTGCTCTTCGTTTTAGAGCTATGCTGTTTTGAATGGTCCCAAAAC
lpg1907_repeat+spacer	GTTTTAGAGCTATGCTGTTTTGAATGGTCCCAAAACAATAAGAACAGCCCTTTGCTCTTC
lpg1907_SpacerRC+repeat	GAAGAGCAAAGGGCTGTTCTTATTGTTTTAGAGCTATGCTGTTTTGAATGGTCCCAAAAC
lpg1907_repeat+SpacerRC	GTTTTAGAGCTATGCTGTTTTGAATGGTCCCAAAACGAAGAGCAAAGGGCTGTTCTTATT
lpg1907_Spacer+repeatRC	AATAAGAACAGCCCTTTGCTCTTCGTTTTGGGACCATTCAAAACAGCATAGCTCTAAAAC
lpg1907_repeatRC+spacer	GTTTTGGGACCATTCAAAACAGCATAGCTCTAAAACAATAAGAACAGCCCTTTGCTCTTC
lpg1907_SpacerRC+repeatRC	GAAGAGCAAAGGGCTGTTCTTATTGTTTTGGGACCATTCAAAACAGCATAGCTCTAAAAC
lpg1907_repeatRC+SpacerRC	GTTTTGGGACCATTCAAAACAGCATAGCTCTAAAACGAAGAGCAAAGGGCTGTTCTTATT
lpg1959_Spacer+repeat	TTAATGCCGCCTTGAGAATTGTATGTTTTAGAGCTATGCTGTTTTGAATGGTCCCAAAAC
lpg1959_repeat+spacer	GTTTTAGAGCTATGCTGTTTTGAATGGTCCCAAAACTTAATGCCGCCTTGAGAATTGTAT
lpg1959_SpacerRC+repeat	ATACAATTCTCAAGGCGGCATTAAGTTTTAGAGCTATGCTGTTTTGAATGGTCCCAAAAC
lpg1959_repeat+SpacerRC	GTTTTAGAGCTATGCTGTTTTGAATGGTCCCAAAACATACAATTCTCAAGGCGGCATTAA
lpg1959_Spacer+repeatRC	TTAATGCCGCCTTGAGAATTGTATGTTTTGGGACCATTCAAAACAGCATAGCTCTAAAAC
lpg1959_repeatRC+spacer	GTTTTGGGACCATTCAAAACAGCATAGCTCTAAAACTTAATGCCGCCTTGAGAATTGTAT
lpg1959_SpacerRC+repeatRC	ATACAATTCTCAAGGCGGCATTAAGTTTTGGGACCATTCAAAACAGCATAGCTCTAAAAC
lpg1959_repeatRC+SpacerRC	GTTTTGGGACCATTCAAAACAGCATAGCTCTAAAACATACAATTCTCAAGGCGGCATTAA
lpg2223_Spacer+repeat	TAGATAATACTTAAACTCTCCTGCGTTTTAGAGCTATGCTGTTTTGAATGGTCCCAAAAC
lpg2223_repeat+spacer	GTTTTAGAGCTATGCTGTTTTGAATGGTCCCAAAACTAGATAATACTTAAACTCTCCTGC
lpg2223_SpacerRC+repeat	GCAGGAGAGTTTAAGTATTATCTAGTTTTAGAGCTATGCTGTTTTGAATGGTCCCAAAAC
lpg2223_repeat+SpacerRC	GTTTTAGAGCTATGCTGTTTTGAATGGTCCCAAAACGCAGGAGAGTTTAAGTATTATCTA
lpg2223_Spacer+repeatRC	TAGATAATACTTAAACTCTCCTGCGTTTTGGGACCATTCAAAACAGCATAGCTCTAAAAC
lpg2223_repeatRC+spacer	GTTTTGGGACCATTCAAAACAGCATAGCTCTAAAACTAGATAATACTTAAACTCTCCTGC
lpg2223_SpacerRC+repeatRC	GCAGGAGAGTTTAAGTATTATCTAGTTTTGGGACCATTCAAAACAGCATAGCTCTAAAAC
lpg2223_repeatRC+SpacerRC	GTTTTGGGACCATTCAAAACAGCATAGCTCTAAAACGCAGGAGAGTTTAAGTATTATCTA
lpg2244_Spacer+repeat	ATTTGGCTTTCAAGTCGCTTCTTAGTTTTAGAGCTATGCTGTTTTGAATGGTCCCAAAAC
lpg2244_repeat+spacer	GTTTTAGAGCTATGCTGTTTTGAATGGTCCCAAAACATTTGGCTTTCAAGTCGCTTCTTA
lpg2244_SpacerRC+repeat	TAAGAAGCGACTTGAAAGCCAAATGTTTTAGAGCTATGCTGTTTTGAATGGTCCCAAAAC
lpg2244_repeat+SpacerRC	GTTTTAGAGCTATGCTGTTTTGAATGGTCCCAAAACTAAGAAGCGACTTGAAAGCCAAAT
lpg2244_Spacer+repeatRC	ATTTGGCTTTCAAGTCGCTTCTTAGTTTTGGGACCATTCAAAACAGCATAGCTCTAAAAC
lpg2244_repeatRC+spacer	GTTTTGGGACCATTCAAAACAGCATAGCTCTAAAACATTTGGCTTTCAAGTCGCTTCTTA
lpg2244_SpacerRC+repeatRC	TAAGAAGCGACTTGAAAGCCAAATGTTTTGGGACCATTCAAAACAGCATAGCTCTAAAAC
lpg2244_repeatRC+SpacerRC	GTTTTGGGACCATTCAAAACAGCATAGCTCTAAAACTAAGAAGCGACTTGAAAGCCAAAT
lpg2271_Spacer+repeat	CAAGAGCCGGGCATTGTTGTAAGAGTTTTAGAGCTATGCTGTTTTGAATGGTCCCAAAAC
lpg2271_repeat+spacer	GTTTTAGAGCTATGCTGTTTTGAATGGTCCCAAAACCAAGAGCCGGGCATTGTTGTAAGA
lpg2271_SpacerRC+repeat	TCTTACAACAATGCCCGGCTCTTGGTTTTAGAGCTATGCTGTTTTGAATGGTCCCAAAAC
lpg2271_repeat+SpacerRC	GTTTTAGAGCTATGCTGTTTTGAATGGTCCCAAAACTCTTACAACAATGCCCGGCTCTTG
lpg2271_Spacer+repeatRC	CAAGAGCCGGGCATTGTTGTAAGAGTTTTGGGACCATTCAAAACAGCATAGCTCTAAAAC
lpg2271_repeatRC+spacer	GTTTTGGGACCATTCAAAACAGCATAGCTCTAAAACCAAGAGCCGGGCATTGTTGTAAGA
lpg2271_SpacerRC+repeatRC	TCTTACAACAATGCCCGGCTCTTGGTTTTGGGACCATTCAAAACAGCATAGCTCTAAAAC
lpg2271_repeatRC+SpacerRC	GTTTTGGGACCATTCAAAACAGCATAGCTCTAAAACTCTTACAACAATGCCCGGCTCTTG
lpg2552_Spacer+repeat	TCTTCTTAAAACCATTATCACTTCGTTTTAGAGCTATGCTGTTTTGAATGGTCCCAAAAC
lpg2552_repeat+spacer	GTTTTAGAGCTATGCTGTTTTGAATGGTCCCAAAACTCTTCTTAAAACCATTATCACTTC
lpg2552_SpacerRC+repeat	GAAGTGATAATGGTTTTAAGAAGAGTTTTAGAGCTATGCTGTTTTGAATGGTCCCAAAAC
lpg2552_repeat+SpacerRC	GTTTTAGAGCTATGCTGTTTTGAATGGTCCCAAAACGAAGTGATAATGGTTTTAAGAAGA
lpg2552_Spacer+repeatRC	TCTTCTTAAAACCATTATCACTTCGTTTTGGGACCATTCAAAACAGCATAGCTCTAAAAC
lpg2552_repeatRC+spacer	GTTTTGGGACCATTCAAAACAGCATAGCTCTAAAACTCTTCTTAAAACCATTATCACTTC
lpg2552_SpacerRC+repeatRC	GAAGTGATAATGGTTTTAAGAAGAGTTTTGGGACCATTCAAAACAGCATAGCTCTAAAAC
lpg2552_repeatRC+SpacerRC	GTTTTGGGACCATTCAAAACAGCATAGCTCTAAAACGAAGTGATAATGGTTTTAAGAAGA
lpg2584_Spacer+repeat	GGTTTCTATATTTTCAGTGATTCGGTTTTAGAGCTATGCTGTTTTGAATGGTCCCAAAAC
lpg2584_repeat+spacer	GTTTTAGAGCTATGCTGTTTTGAATGGTCCCAAAACGGTTTCTATATTTTCAGTGATTCG
lpg2584_SpacerRC+repeat	CGAATCACTGAAAATATAGAAACCGTTTTAGAGCTATGCTGTTTTGAATGGTCCCAAAAC
lpg2584_repeat+SpacerRC	GTTTTAGAGCTATGCTGTTTTGAATGGTCCCAAAACCGAATCACTGAAAATATAGAAACC
lpg2584_Spacer+repeatRC	GGTTTCTATATTTTCAGTGATTCGGTTTTGGGACCATTCAAAACAGCATAGCTCTAAAAC
lpg2584_repeatRC+spacer	GTTTTGGGACCATTCAAAACAGCATAGCTCTAAAACGGTTTCTATATTTTCAGTGATTCG
lpg2584_SpacerRC+repeatRC	CGAATCACTGAAAATATAGAAACCGTTTTGGGACCATTCAAAACAGCATAGCTCTAAAAC
lpg2584_repeatRC+SpacerRC	GTTTTGGGACCATTCAAAACAGCATAGCTCTAAAACCGAATCACTGAAAATATAGAAACC
lpg2628_Spacer+repeat	AAACAACATAACTTTAGTGAAAGTGTTTTAGAGCTATGCTGTTTTGAATGGTCCCAAAAC
lpg2628_repeat+spacer	GTTTTAGAGCTATGCTGTTTTGAATGGTCCCAAAACAAACAACATAACTTTAGTGAAAGT
lpg2628_SpacerRC+repeat	ACTTTCACTAAAGTTATGTTGTTTGTTTTAGAGCTATGCTGTTTTGAATGGTCCCAAAAC
lpg2628_repeat+SpacerRC	GTTTTAGAGCTATGCTGTTTTGAATGGTCCCAAAACACTTTCACTAAAGTTATGTTGTTT
lpg2628_Spacer+repeatRC	AAACAACATAACTTTAGTGAAAGTGTTTTGGGACCATTCAAAACAGCATAGCTCTAAAAC
lpg2628_repeatRC+spacer	GTTTTGGGACCATTCAAAACAGCATAGCTCTAAAACAAACAACATAACTTTAGTGAAAGT
lpg2628_SpacerRC+repeatRC	ACTTTCACTAAAGTTATGTTGTTTGTTTTGGGACCATTCAAAACAGCATAGCTCTAAAAC
lpg2628_repeatRC+SpacerRC	GTTTTGGGACCATTCAAAACAGCATAGCTCTAAAACACTTTCACTAAAGTTATGTTGTTT
lpg2692_Spacer+repeat	CCAGGGATTTTAAACTGGGGACTTGTTTTAGAGCTATGCTGTTTTGAATGGTCCCAAAAC
lpg2692_repeat+spacer	GTTTTAGAGCTATGCTGTTTTGAATGGTCCCAAAACCCAGGGATTTTAAACTGGGGACTT
lpg2692_SpacerRC+repeat	AAGTCCCCAGTTTAAAATCCCTGGGTTTTAGAGCTATGCTGTTTTGAATGGTCCCAAAAC
lpg2692_repeat+SpacerRC	GTTTTAGAGCTATGCTGTTTTGAATGGTCCCAAAACAAGTCCCCAGTTTAAAATCCCTGG
lpg2692_Spacer+repeatRC	CCAGGGATTTTAAACTGGGGACTTGTTTTGGGACCATTCAAAACAGCATAGCTCTAAAAC
lpg2692_repeatRC+spacer	GTTTTGGGACCATTCAAAACAGCATAGCTCTAAAACCCAGGGATTTTAAACTGGGGACTT
lpg2692_SpacerRC+repeatRC	AAGTCCCCAGTTTAAAATCCCTGGGTTTTGGGACCATTCAAAACAGCATAGCTCTAAAAC
lpg2692_repeatRC+SpacerRC	GTTTTGGGACCATTCAAAACAGCATAGCTCTAAAACAAGTCCCCAGTTTAAAATCCCTGG
lpg2733_Spacer+repeat	CGTTTTAACTCATCCACTGGGGGTGTTTTAGAGCTATGCTGTTTTGAATGGTCCCAAAAC
lpg2733_repeat+spacer	GTTTTAGAGCTATGCTGTTTTGAATGGTCCCAAAACCGTTTTAACTCATCCACTGGGGGT
lpg2733_SpacerRC+repeat	ACCCCCAGTGGATGAGTTAAAACGGTTTTAGAGCTATGCTGTTTTGAATGGTCCCAAAAC
lpg2733_repeat+SpacerRC	GTTTTAGAGCTATGCTGTTTTGAATGGTCCCAAAACACCCCCAGTGGATGAGTTAAAACG
lpg2733_Spacer+repeatRC	CGTTTTAACTCATCCACTGGGGGTGTTTTGGGACCATTCAAAACAGCATAGCTCTAAAAC
lpg2733_repeatRC+spacer	GTTTTGGGACCATTCAAAACAGCATAGCTCTAAAACCGTTTTAACTCATCCACTGGGGGT
lpg2733_SpacerRC+repeatRC	ACCCCCAGTGGATGAGTTAAAACGGTTTTGGGACCATTCAAAACAGCATAGCTCTAAAAC
lpg2733_repeatRC+SpacerRC	GTTTTGGGACCATTCAAAACAGCATAGCTCTAAAACACCCCCAGTGGATGAGTTAAAACG
lpg2804_Spacer+repeat	GAGAACCTTAACCCGGTAATGATTGTTTTAGAGCTATGCTGTTTTGAATGGTCCCAAAAC
lpg2804_repeat+spacer	GTTTTAGAGCTATGCTGTTTTGAATGGTCCCAAAACGAGAACCTTAACCCGGTAATGATT
lpg2804_SpacerRC+repeat	AATCATTACCGGGTTAAGGTTCTCGTTTTAGAGCTATGCTGTTTTGAATGGTCCCAAAAC
lpg2804_repeat+SpacerRC	GTTTTAGAGCTATGCTGTTTTGAATGGTCCCAAAACAATCATTACCGGGTTAAGGTTCTC
lpg2804_Spacer+repeatRC	GAGAACCTTAACCCGGTAATGATTGTTTTGGGACCATTCAAAACAGCATAGCTCTAAAAC
lpg2804_repeatRC+spacer	GTTTTGGGACCATTCAAAACAGCATAGCTCTAAAACGAGAACCTTAACCCGGTAATGATT
lpg2804_SpacerRC+repeatRC	AATCATTACCGGGTTAAGGTTCTCGTTTTGGGACCATTCAAAACAGCATAGCTCTAAAAC
lpg2804_repeatRC+SpacerRC	GTTTTGGGACCATTCAAAACAGCATAGCTCTAAAACAATCATTACCGGGTTAAGGTTCTC
lpg2806_Spacer+repeat	TATAGGCGTCAACGGATATTCAATGTTTTAGAGCTATGCTGTTTTGAATGGTCCCAAAAC
lpg2806_repeat+spacer	GTTTTAGAGCTATGCTGTTTTGAATGGTCCCAAAACTATAGGCGTCAACGGATATTCAAT
lpg2806_SpacerRC+repeat	ATTGAATATCCGTTGACGCCTATAGTTTTAGAGCTATGCTGTTTTGAATGGTCCCAAAAC
lpg2806_repeat+SpacerRC	GTTTTAGAGCTATGCTGTTTTGAATGGTCCCAAAACATTGAATATCCGTTGACGCCTATA
lpg2806_Spacer+repeatRC	TATAGGCGTCAACGGATATTCAATGTTTTGGGACCATTCAAAACAGCATAGCTCTAAAAC
lpg2806_repeatRC+spacer	GTTTTGGGACCATTCAAAACAGCATAGCTCTAAAACTATAGGCGTCAACGGATATTCAAT
lpg2806_SpacerRC+repeatRC	ATTGAATATCCGTTGACGCCTATAGTTTTGGGACCATTCAAAACAGCATAGCTCTAAAAC
lpg2806_repeatRC+SpacerRC	GTTTTGGGACCATTCAAAACAGCATAGCTCTAAAACATTGAATATCCGTTGACGCCTATA
lpg2874_Spacer+repeat	TTTCTGACTTCCATTTCAAATTGGGTTTTAGAGCTATGCTGTTTTGAATGGTCCCAAAAC
lpg2874_repeat+spacer	GTTTTAGAGCTATGCTGTTTTGAATGGTCCCAAAACTTTCTGACTTCCATTTCAAATTGG
lpg2874_SpacerRC+repeat	CCAATTTGAAATGGAAGTCAGAAAGTTTTAGAGCTATGCTGTTTTGAATGGTCCCAAAAC
lpg2874_repeat+SpacerRC	GTTTTAGAGCTATGCTGTTTTGAATGGTCCCAAAACCCAATTTGAAATGGAAGTCAGAAA
lpg2874_Spacer+repeatRC	TTTCTGACTTCCATTTCAAATTGGGTTTTGGGACCATTCAAAACAGCATAGCTCTAAAAC
lpg2874_repeatRC+spacer	GTTTTGGGACCATTCAAAACAGCATAGCTCTAAAACTTTCTGACTTCCATTTCAAATTGG
lpg2874_SpacerRC+repeatRC	CCAATTTGAAATGGAAGTCAGAAAGTTTTGGGACCATTCAAAACAGCATAGCTCTAAAAC
lpg2874_repeatRC+SpacerRC	GTTTTGGGACCATTCAAAACAGCATAGCTCTAAAACCCAATTTGAAATGGAAGTCAGAAA
lpg2884_Spacer+repeat	TCCAGAGTCAAACCAATCAAACCAGTTTTAGAGCTATGCTGTTTTGAATGGTCCCAAAAC
lpg2884_repeat+spacer	GTTTTAGAGCTATGCTGTTTTGAATGGTCCCAAAACTCCAGAGTCAAACCAATCAAACCA
lpg2884_SpacerRC+repeat	TGGTTTGATTGGTTTGACTCTGGAGTTTTAGAGCTATGCTGTTTTGAATGGTCCCAAAAC
lpg2884_repeat+SpacerRC	GTTTTAGAGCTATGCTGTTTTGAATGGTCCCAAAACTGGTTTGATTGGTTTGACTCTGGA
lpg2884_Spacer+repeatRC	TCCAGAGTCAAACCAATCAAACCAGTTTTGGGACCATTCAAAACAGCATAGCTCTAAAAC
lpg2884_repeatRC+spacer	GTTTTGGGACCATTCAAAACAGCATAGCTCTAAAACTCCAGAGTCAAACCAATCAAACCA
lpg2884_SpacerRC+repeatRC	TGGTTTGATTGGTTTGACTCTGGAGTTTTGGGACCATTCAAAACAGCATAGCTCTAAAAC
lpg2884_repeatRC+SpacerRC	GTTTTGGGACCATTCAAAACAGCATAGCTCTAAAACTGGTTTGATTGGTTTGACTCTGGA
lpg2885_Spacer+repeat	TATGCTGGCAAATGCCGCCAGAACGTTTTAGAGCTATGCTGTTTTGAATGGTCCCAAAAC
lpg2885_repeat+spacer	GTTTTAGAGCTATGCTGTTTTGAATGGTCCCAAAACTATGCTGGCAAATGCCGCCAGAAC
lpg2885_SpacerRC+repeat	GTTCTGGCGGCATTTGCCAGCATAGTTTTAGAGCTATGCTGTTTTGAATGGTCCCAAAAC
lpg2885_repeat+SpacerRC	GTTTTAGAGCTATGCTGTTTTGAATGGTCCCAAAACGTTCTGGCGGCATTTGCCAGCATA
lpg2885_Spacer+repeatRC	TATGCTGGCAAATGCCGCCAGAACGTTTTGGGACCATTCAAAACAGCATAGCTCTAAAAC
lpg2885_repeatRC+spacer	GTTTTGGGACCATTCAAAACAGCATAGCTCTAAAACTATGCTGGCAAATGCCGCCAGAAC
lpg2885_SpacerRC+repeatRC	GTTCTGGCGGCATTTGCCAGCATAGTTTTGGGACCATTCAAAACAGCATAGCTCTAAAAC
lpg2885_repeatRC+SpacerRC	GTTTTGGGACCATTCAAAACAGCATAGCTCTAAAACGTTCTGGCGGCATTTGCCAGCATA
lpg2888_Spacer+repeat	GGTAAGATTGAAGAATTAAACTACGTTTTAGAGCTATGCTGTTTTGAATGGTCCCAAAAC
lpg2888_repeat+spacer	GTTTTAGAGCTATGCTGTTTTGAATGGTCCCAAAACGGTAAGATTGAAGAATTAAACTAC
lpg2888_SpacerRC+repeat	GTAGTTTAATTCTTCAATCTTACCGTTTTAGAGCTATGCTGTTTTGAATGGTCCCAAAAC
lpg2888_repeat+SpacerRC	GTTTTAGAGCTATGCTGTTTTGAATGGTCCCAAAACGTAGTTTAATTCTTCAATCTTACC
lpg2888_Spacer+repeatRC	GGTAAGATTGAAGAATTAAACTACGTTTTGGGACCATTCAAAACAGCATAGCTCTAAAAC
lpg2888_repeatRC+spacer	GTTTTGGGACCATTCAAAACAGCATAGCTCTAAAACGGTAAGATTGAAGAATTAAACTAC
lpg2888_SpacerRC+repeatRC	GTAGTTTAATTCTTCAATCTTACCGTTTTGGGACCATTCAAAACAGCATAGCTCTAAAAC
lpg2888_repeatRC+SpacerRC	GTTTTGGGACCATTCAAAACAGCATAGCTCTAAAACGTAGTTTAATTCTTCAATCTTACC
lpg3000_Spacer+repeat	TCCAGTTTACTATCCTTCGGAATTGTTTTAGAGCTATGCTGTTTTGAATGGTCCCAAAAC
lpg3000_repeat+spacer	GTTTTAGAGCTATGCTGTTTTGAATGGTCCCAAAACTCCAGTTTACTATCCTTCGGAATT
lpg3000_SpacerRC+repeat	AATTCCGAAGGATAGTAAACTGGAGTTTTAGAGCTATGCTGTTTTGAATGGTCCCAAAAC
lpg3000_repeat+SpacerRC	GTTTTAGAGCTATGCTGTTTTGAATGGTCCCAAAACAATTCCGAAGGATAGTAAACTGGA
lpg3000_Spacer+repeatRC	TCCAGTTTACTATCCTTCGGAATTGTTTTGGGACCATTCAAAACAGCATAGCTCTAAAAC
lpg3000_repeatRC+spacer	GTTTTGGGACCATTCAAAACAGCATAGCTCTAAAACTCCAGTTTACTATCCTTCGGAATT
lpg3000_SpacerRC+repeatRC	AATTCCGAAGGATAGTAAACTGGAGTTTTGGGACCATTCAAAACAGCATAGCTCTAAAAC
lpg3000_repeatRC+SpacerRC	GTTTTGGGACCATTCAAAACAGCATAGCTCTAAAACAATTCCGAAGGATAGTAAACTGGA